AA	Altezas
abr	abreviatura
abrev	abreviação
abs	absoluto
adit	aditivo
adj	adjetivo
adm	administração
adv	advérbio
advers	adversativo
af	africano
afr	africano
ag	agrícola
al	outros
alm	almirante
alt	alternativo
amer	americano
anal	analogia
ant	antigo
anton	antonomásia
antr	antropônimo
antrop	antropologia
antropon	antroponímico
ap	apartamento
apass	apassivador
aport	aportuguesado
aprox	aproximadamente
apto	apartamento
ár	árabe
aráb	arábico
arc	arcaico
arceb	arcebispo
arcip	arcipreste
aritm	aritmética
arq	arquivo
art	artigo
artesan	artesanato
artilh	artilharia
artíst	artístico
ass	assinado
assoc	associação
ast	asturiano
astr	astronomia
astron	astronomia
astronáut	astronáutica
at	ativo
át	átono
atl	atletismo
atôm	atômico
aum	aumentativo
autom	automobilismo
aux	auxiliar
av	avenida
Av	avenida	
aven	avenida
aviaç	aviação
b	baixo
bact	bacteriologia
bacter	bacteriologia
bal	balística
balíst	balística
bált	báltico
bárb	bárbaro
basq	basquetebol
beng	bengali
berb	berbere
bíb	bíblico
bíbl	bíblico
bibl	biblioteca
bibliof	bibliofilia
bibliog	bibliografia
bibliogr	bibliografia
bibliol	bibliologia
bibliôn	bibliônimo
bibliot	biblioteca
biblog	bibliografia
biblol	bibliologia
biblon	biblionímia
bim	bimensal
biodim	biodinâmica
biofís	biofísica
biogên	biogênese
biogen	biogenético
biogeo	biogeografia
biogeog	biogeografia
biogeogr	biogeografia
biogr	biografia
biol	biologia
biom	biometria
bioq	bioquímica
bioquím	bioquímica
biot	biotaxia
biotip	biotipologia
biotipol	biotipologia
birm	birmanês
birrel	birrelativo
bisp	bispado
bispd	bispado
bitr	bitransitivo
bitrans	bitransitivo
biz	bizantino
bm	baixa-mar
boêm	boêmio
bol	boletim
boliv	boliviano
bomb	bombeiros
bor	boreal
bord	bordado
borg	borguinhão
bot	botânica
br	brasileiro
Bras	Brasil
bras	brasileiro
bret	bretão
Brig	brigadeiro
brig	brigadeiro
brit	britânico
brom	bromatologia
bromat	bromatologia
btl	batalhão
bud	budismo
búlg	búlgaro
bur	burocracia
burl	burlesco
buroc	burocracia
c	cerca
C	Cristo
c-alm	contra-almirante
C-Alm	contra-almirante
c-riq	costa-riquenho
cab	cabala
cabo-verd	caboverdianismo
cálc	cálculo
calcog	calcografia
cald	caldeu
calig	caligrafia
caligr	caligrafia
calorim	calorimetria
calv	calvinismo
calvin	calvinismo
câm	câmara
can	canadense
can	canônico
canad	canadense
canaliz	canalização
cant	cantão
cap	capítulo
Cap-ten	capitão-tenente
cap-ten	capitão-tenente
capac	capacidade
capit	capitalismo
capix	capixaba
caps	capítulos
capt	capitão
card	cardeal
card	cardinal
Carid	Caridade
cart	cartografia
cart	cartonado
cartogr	cartografia
cast	castelhano
casuís	casuística
casuíst	casuística
cat	catalão
cat	caterva
cat	católico
catacr	catacrese
catal	catálise
catar	catarinense
catarin	catarinense
categ	categoria
Catol	catolicismo
catól	católico
Catolic	catolicismo
catóp	catóptrica
catópt	catóptrica
caus	causal
causalid	causalidade
cav	cavalaria
cc	comarca
CC	Cristianíssimas
cear	cearense
celt	celta
célt	céltico
cên	cênico
cenog	cenografia
cent	centavo
cênt	cêntimo
centr	central
cer	cerâmica
cerâm	cerâmica
cerv	cervejaria
cest	cestaria
cf	conferir
cfr	conferir
cg	centigrama
cgf	centigrama-força
cgr	centígrado
chanc	chancelaria
chancel	chancelaria
chap	chapelaria
chapel	chapelaria
chil	chileno
chin	chinês
chul	chulo
Cia	companhia
ciber	cibernética
cibern	cibernética
cicl	ciclismo
cid	cidade
cien	científico
ciênc	ciência
cient	científico
cig	cigano
cin	cinegética
cineg	cinegética
cinem	cinematografia
cinematogr	cinematografia
cing	cingalês
cinol	cinologia
cinz	cinzelaria
cir	cirurgia
circ	circense
círc	círculo
circunscr	circunscrição
cirurg	cirurgia
cit	citação
citol	citologia
civ	civil
cl	centilitro
clas	classicismo
clás	clássico
cláss	clássico
clich	clicheria
clim	climatologia
climatol	climatologia
clín	clínica
cm	centímetro
cob	cobertura
cód	código
cogn	cognome
col	coleção
colet	coletivo
colomb	colombiano
cols	colunas
com	comercial
comb	combinação
combin	combinação
comdor	comendador
comend	comendador
comerc	comercial
comp	comparativo
compar	comparativo
compl	complemento
compr	comprimento
comte	comandante
comunic	comunicação
côn	cônego
conc	concani
conc	concessivo
conces	concessivo
concess	concessiva
concl	conclusivo
concr	concreta
concret	concretismo
cond	condicional
cond	condicional
cond	condutor
condic	condicional
conf	conferência
conf	conformativa
Confed	confederação
confed	confederação
confeit	confeitaria
confl	confluência
confls	confluências
cong	conguês
conhec	conhecimento
conj	conjugação
conjug	conjugação
conq	conquiliologia
conquil	conquiliologia
conquiliol	conquiliologia
cons	consecutivo
cons	conselheiro
cons	consuetudinário
consec	consecutivo
consel	conselheiro
conselh	conselheiro
conseq	consequente
const	constitucional
Const	constituição
const	constituição
constel	constelação
constr	construção
constta	constitucionalista
consuet	consuetudinário
cont	contabilidade
cont	contemporâneo
contab	contabilidade
contemp	contemporâneo
contemp	contemporâneo
contr	contrário
coord	coordenativo
cop	copulativo
copul	copulativo
copulat	copulativo
coreog	coreografia
coreogr	coreografia
corog	corografia
corogr	corografia
corp	corporativo
corr	correção
correi	correição
corresp	correspondência
corrup	corruptela
corrupt	corruptela
corrut	corrutela
cos	co-seno
cos	co-seno
cosec	co-secante
cosm	cosmetologia
cosmog	cosmografia
cosmol	cosmologia
cost	costura
costa-ric	costa-ricense
costa-riq	costa-riquenho
cot	co-tangente
côv	côvado
cp	comparar
créd	crédito
cresc	crescente
crim	criminal
crim	criminologia
criminol	criminologia
cript	criptônimo
criptog	criptografia
crist	cristalografia
cristal	cristalografia
cristalogr	cristalografia
cristand	cristandade
cristian	cristianismo
crôn	crônica
cron	cronologia
cronol	cronologia
cronom	cronometria
cronôn	cronônimo
crust	crustáceo
ctv	centavo
cul	culinária
culin	culinária
cult	cultura
cut	cutelaria
cutel	cutelaria
cv	centavo
cvs	centavos
Cx	caixa
cx	caixa
d	depois
D	dom
Da	dona
dactilog	dactilografia
dactilogr	dactilografia
dactilos	dactiloscopia
dactilosc	dactiloscopia
dad	dadaísmo
dag	decagrama
dal	decalitro
dam	decâmetro
dasim	dasimetria
dason	dasonomia
dast	decastéreo
dat	dativo
DD	Digníssimo
dec	decoração
decl	declinação
declin	declinação
decor	decoração
Decr	decrescendo
decr	decreto
ded	dedutivo
def	definido
defin	definição
dem	demonstrativo
democ	democrático
democr	democracia
demog	demografia
demogr	demografia
demonstr	demonstrativo
dens	densidade
dep	departamento
depr	depreciativo
deprec	depreciativo
deps	departamentos
deriv	derivação
derm	dermatologia
des	desusado
desc	desconto
descr	descritivo
Desemb	desembargador
desemb	desembargador
desemboc	desembocadura
desen	desenho
desin	desinência
desp	despesa
despor	desporto
desus	desusado
det	determinativo
determ	determinativo
dev	deverbal
dg	decigrama
dgf	decigrama-força
dgr	decígrado
di	dioptria
diác	diácono
dial	dialeto
dialet	dialetal
dialét	dialética
dic	dicionário
did	didática
diet	dietético
dif	diferente
Digmo	Digníssimo
dim	diminutivo
dimin	diminutivo
din	dinamarquês
dinam	dinamarquês
dinâm	dinâmico
dioc	diocese
dipl	diploma
diplom	diplomática
dir	direito
disc	discurso
disfem	disfemismo
disfem	disfemismo
diss	dissertação
distr	distributivo
docs	documentos
docum	documentação
dog	dogmático
dogm	dogmático
dogmát	dogmático
dól	dólar
dom	doméstico
domin	dominicano
domín	domínico
dór	dórico
Dr	doutor
Dra	doutora
dram	dramático
dram	dramático
Dras	doutoras
drav	dravídico
Drs	doutores
dst	decistéreo
dual	dualismo
dualid	dualidade
dur	dureza
ecd	ecdótica
ecl	eclesiástico
écl	écloga
ecles	eclesiástico
ecol	ecologia
econ	economia	
ed	edição
edif	edifício
educ	educação
EE	editores
efem	efeméride
egíp	egípcio
el	elemento
elem	elemento
eletr	eletricidade
elétr	elétrico
eletrodin	eletrodinâmica
eletrol	eletrologia
eletrom	eletrometria
eletrôn	eletrônica
eletrot	eletroterapia
elipt	elipticamente
elipt	elíptico
Em	Eminência
Emb	Embaixador
emb	Embaixador
embal	embalagem
embr	embriologia
embriol	embriologia
emigr	emigração
emol	emolumento
emp	empresa
emp	empresarial
empír	empírico
empr	empresa
emprés	empréstimo
enc	encadernação
encícl	encíclica
encicl	enciclopédia
End	endereço	
endoc	endocrinologia
energ	energia
energét	energética
enf	enfermagem
eng	engenheiro
enol	enologia
ens	ensino
ent	entomologia
entom	entomologia
entomol	entomologia
enx	enxadrismo
epig	epigrafia
epigr	epigrafia
eq	equipamento
equat	equatoriano
equit	equitação
equiv	equivalente
ergol	ergologia
erud	erudito
Esc	escadas
esc	escocês
escand	escandinavo
escoc	escocês
escol	escolar
escolást	escolástica
escr	escrito
escult	escultura
esgr	esgrima
esl	eslavo
eslav	eslavo
eslov	eslovaco
esot	esoterismo
esp	espanhol
esp	especial
espec	especial
especialm	especialmente
especif	especificação
específ	específico
espect	espectroscopia
espectrogr	espectrografia
espel	espeleologia
espeleol	espeleologia
espet	espetáculo
espir	espiritismo
esport	esporte
esq	esquerdo
est	estado
estad	estadismo
estat	estatística
estatíst	estatística
estenog	estenografia
estenogr	estenografia
estereogr	estereografia
estét	estética
estil	estilística
eston	estoniano
estr	estratigrafia
estrang	estrangeiro
estrangeir	estrangeirismo
estrat	estratégia
estratég	estratégia
estrem	estremenho
estrut	estrutura
estud	estudante
et	ética
etc	etcétera
etim	etimologia
etimol	etimologia
etióp	etiópico
étn	étnico
etn	etnônimo
etnog	etnografia
etnogr	etnografia
etnol	etnologia
etnolog	etnologia
etol	etologia
euf	eufemismo
eufêm	eufêmico
eufem	eufemismo
eufon	eufonia
eufôn	eufônico
eufor	euforia
eur	europeu
Ex	Excelência
ex	exemplo
Exa	Excelência
excl	exclamação
excl	exclamativo
exclam	exclamação
exclamat	exclamativo
excurs	excursionismo
exe	exército
exérc	exército
Exma	Excelentíssimo
Exmo	Excelentíssimo
exp	experiência
exper	experiência
expl	expletivo
expl	explicativo
expl	explosivo
explet	expletivo
explor	exploração
explos	explosivo
export	exportação
expr	expressão
express	expressivo
ext	extensão
ext	extensão
ext	extenso
extens	extensivo
F	Farad
f	feminino
fáb	fábrica
fac	faculdade
falc	falcoaria
falcoar	falcoaria
fam	família
fam	familiar
farm	farmacêutico
farmac	farmacologia
farmacol	farmacologia
farmacop	farmacopéia
fasc	fascículo
fascs	fascículos
fauv	fauvismo
fed	federação
feder	federação
feit	feitiçaria
fem	feminino
fen	fenício
fenom	fenomenalismo
fenôm	fenômeno
fer	ferrovia
ferrad	ferradoria
ferrov	ferrovia
feud	feudal
feud	feudal
fev	fevereiro
FF	Fidelíssimas
ff	folha
fg	figura
fig	figura
figurat	figurativismo
figurativ	figurativismo
fil	filologia
filat	filatelia
filol	filologia
filos	filosofia
fin	final
finl	finlandês
fís	física
fis	fisiologia
fís-quím	físico-química
fisc	fiscal
fisioc	fisiocracia
fisiocr	fisiocracia
fisiocrat	fisiocratismo
fisiol	fisiologia
fisl	fisiologia
fispat	fisiopatologia
fitog	fitogeografia
fitol	fitologia
fitopat	fitopatologia
fitossoc	fitossociologia
fl	flexão
flam	flamengo
flex	flexão
floric	floricultura
fls	folhas
flum	fluminense
flumin	fluminense
fluv	fluvial
fluv	fluvial
fm	forma
fo	fólio
fog	fogueiro
fol	folha
folc	folclore
folh	folheto
fols	folhas
fon	fonética
fonét	fonética
fonol	fonologia
for	forense
form	formação
fórm	fórmula
formul	formulário
fort	fortificação
fos	fólios
fós	fóssil
fot	fotografia
fotoan	fotoanálise
fotoanál	fotoanálise
fotogr	fotografia
fotom	fotometria
fov	fovismo
fr	francês
fr-maç	franco-maçonaria
frac	fracionário
fracc	fraccionário
frânc	frâncico
franc	franco
freg	freguesia
frenol	frenologia
freq	frequentativo
frig	frigorífico
frut	fruticultura
fs	fac-símile
fss	fac-símiles
ft	pé
fulv	fulvismo
fund	fundação
fut	futuro
futb	futebol
futeb	futebol
futur	futurismo
G	gauss
g	grama
gaél	gaélico
gal	galego
Gal	General
galic	galicismo
galv	galvanismo
gar	garimpo
gasc	gascão
gaul	gaulês
gav	gaveta
gen	genealogia
Gen	General
gen	general
gên	gênero
gen	genitivo
geneal	genealogia
genét	genética
genov	genovês
geo	geografia
geod	geodésia
geof	geofísica
geofís	geofísica
geog	geografia
geogn	geognosia
geogr	geografia
geol	geologia
geom	geometria
geomor	geomorfologia
geomorf	geomorfologia
geon	geonímia
geôn	geônimo
ger	geral
ger	geral
germ	germânico
gf	grama-força
GG	Graças
gin	ginástica
ginást	ginástica
ginec	ginecologia
ginecol	ginecologia
gír	gíria
gliptog	gliptografia
gliptogr	gliptografia
gliptol	gliptologia
gliptot	gliptoteca
gloss	glossário
glót	glótica
glotol	glotologia
gn	guinéu
gnom	gnomônica
gót	gótico
gov	governador
Gov	governador
gr	grego
gráf	gráfico
graf	grafologia
grafol	grafologia
grafosc	grafoscopia
gram	gramática
grav	gravura
grd	grande
groen	groenlandês
groenl	groenlandês
gt	gota
guar	guarani
guat	guatemalteco
guatem	guatemalteco
guin	guinéu
gutt	gota
guz	guzarate
h	hora
ha	hectare
hab	habitante
hag	hagiografia
hagiog	hagiografia
hagiogr	hagiografia
hagiol	hagiológico
haplol	haplologia
hast	hastim
hebd	hebdomadário
hebr	hebraico
helm	helmintologia
helmin	helmintologia
helmintol	helmintologia
hem	hematologia
heort	heortônimo
heortôn	heortônimo
her	heráldica
herál	heráldica
heráld	heráldica
herb	herbário
herp	herpetologia
herpét	herpético
herpet	herpetografia
herpetogr	herpetografia
herpetol	herpetologia
het	heteronímia
hg	hectograma
HH	Honras
hib	hibridismo
híb	híbrido
hibr	hibridismo
híbr	híbrido
hibrid	hibridismo
hidr	hidráulico
hidr	hidrografia
hidrául	hidráulica
hidrod	hidrodinâmica
hidrog	hidrografia
hidrogr	hidrografia
hidrol	hidrologia
hidrom	hidrometria
hidrost	hidrostática
hidrot	hidroterapia
hier	hierônimo
hierôn	hierônimo
hierosolim	hierosolimitano
hig	higiene
higr	higrometria
hind	hindu
híp	hípico
hip	hipotético
hipál	hipálage
hipérb	hipérbole
hipiat	hipiatria
hipnot	hipnoterapia
hipnoter	hipnoterapia
hipoc	hipocorístico
hipocor	hipocorístico
hipol	hipologia
hipót	hipótese
hipot	hipotético
hipotét	hipotético
hisp	hispânico
hisp-am	hispano-americano
hisp-amer	hispano-americano
hisp-lat	hispano-latino
hisp-ár	hispano-árabe
hist	história
histol	histologia
historiog	historiografia
historiogr	historiografia
hl	hectolitro
hm	hectômetro
hol	holandês
hom	homônimo
homeo	homeopatia
homeop	homeopatia
homof	homofonia
homog	homografia
homogr	homografia
homon	homonímia
homôn	homônimo
hon	honorário
hond	hondurenho
hort	horticultura
hortic	horticultura
hot	hotentote
hotent	hotentote
hpz	hectopiezo
hum	humano
húng	húngaro
hw	hectowatt
iat	iatismo
ib	ibidem
ibér	ibérico
ibid	ibidem
iconog	iconografia
iconogr	iconografia
iconol	iconologia
ict	ictiologia
ictiol	ictiologia
id	idem
idiot	idiotismo
idol	idolatria
idolol	idololatria
igr	igreja
Il	ilustração
Ilma	ilustríssima
Ilmas	ilustríssimas
Ilmo	ilustríssimo
Ilmos	ilustríssimos
ilum	iluminação
ilus	ilusionismo
ilusion	ilusionismo
ilustr	ilustrado
imigr	imigração
imit	imitação
imp	imperfeito
imper	imperativo
imperat	imperativo
imperf	imperfeito
impes	impessoal
impess	impessoal
import	importação
impr	imprensa
impres	impressionismo
impression	impressionismo
improp	impropriamente
in	polegada
inc	incoativo
incoat	incoativo
incóg	incógnito
ind	indefinido
índ	índice
indef	indefinido
indet	indeterminado
indian	indianismo
indiv	indivíduo
indoch	indochinês
indon	indonésio
indost	indostano
indum	indumentária
indust	industano
indúst	indústria
inf	infinitivo
infan	infantil
infant	infantil
infer	inferioridade
infin	infinitivo
infl	influência
inform	informação
ing	inglês
ins	insular
inscr	inscrição
insep	inseparável
inst	instrumento
instit	instituição
int	interrogativo
integr	integrante
intens	intensivo
interamn	interamnense
interj	interjeição
interjet	interjetivamente
intern	internacional
internac	internacional
interr	interrogativo
interrog	interrogativo
interrogat	interrogativo
intj	interjeição
intr	intransitivo
intrans	intransitivo
inus	inusitado
inv	invariável
invar	invariável
invest	investigação
investig	investigação
iran	iraniano
iraq	iraquiano
irl	irlandês
iron	ironia
irôn	irônico
irr	irregular
irreg	irregular
isl	islandês
islam	islamita
island	islandês
isr	israelita
israel	israelita
it	italiano
ít	ítalo
ital	italianismo
itál	itálico
italian	italianismo
iug	iugoslavo
J	joule
jam	jamaicano
jan	janeiro
jap	japonês
jard	jardinagem
jardin	jardinagem
jav	javanês
jaz	minas	e	jazidas
jes	jesuitismo
joalh	joalharia
joc	jocoso
jorn	jornalismo
Jr	júnior
jud	judaico
jul	julho
jun	junho
jur	jurídico
juris	jurisprudência
jurisp	jurisprudência
jurispr	jurisprudência
just	justiça
kc	quilociclo
kcal	quilocaloria
kg	quilograma
kgf	quilograma-força
kgm	quilogrâmetro
kj	quilojoule
kJ	quilojoule
kl	quilolitro
km	quilômetro
kw	quilowatt
kW	quilowatt
kWh	quilowatt-hora
kwh	quilowatt-hora
l	litro
lab	laboratório
labor	laborterapia
laborat	laboratório
labort	laborterapia
lact	lacticínio
lâm	lâmina
lanç	lançamento
lanc	lanceiro
lap	lapão
lapid	lapidário
larg	largura
lat	latim
latit	latitude
latoar	latoaria
lb	libra
leg	legal
leg	legislação
lég	légua
legisl	legislação
légs	léguas
leit	leitura
let	letão
lex	lexicografia
lib	libanês
lig	ligação
lim	limnologia
limit	limitação
lin	linimento
líng	Língua
ling	linguística
linguíst	linguística
líq	líquido
lit	literalmente
liter	literatura
literal	literalidade
literat	literatura
litog	litografia
litogr	litografia
litol	litologia
lituan	lituano
litur	liturgia
liturg	liturgia
liv	livro
Livr	livraria
ll	linha
lm	lúmen
loc	locução
log	logaritmo
lóg	lógica
logar	logaritmo
logíst	logística
lomb	lombardo
long	longitude
loq	loquitur
lr	lira
Ltd	limitado
Ltda	limitado
ltda	limitado
ludol	ludologia
lug	lugar
lund	lundês
lunf	lunfardo
lus	lusitano
lusit	lusitanismo
luso-afr	luso-africanismo
luso-asit	luso-asiaticismo
lut	luta
luv	Luvaria
m	metro
m-q-perf	mais-que-perfeito
maç	maçonaria
maçon	maçonaria
mad	madeirense
madeir	madeirense
mag	magia
Mag	Magnificência
magn	magnetismo
magnet	magnetismo
magnit	magnitude
mai	maio
maiúsc	maiúscula
Maj	major
maj	major
Maj-Brig	Major-Brigadeiro
maj-brig	major-brigadeiro
Mal	Marechal
malab	malabar
malac	malacologia
malacol	malacologia
malai	malaiala
malg	malgaxe
malh	malharia
mamal	mamalogia
man	manípulo
manuf	manufatura
maomet	maometano
map	mapuche
máq	máquina
maq	maquinista
maquinof	maquinofatura
maranh	maranhense
marc	marcenaria
march	marchantaria
marchet	marcheteria
marg	marginal
marin	marinharia
marinh	marinharia
marít	marítimo
marn	marnotagem
marr	marroquino
marroq	marroquino
martin	martinicano
marx	marxismo
masc	masculino
mat	matemática
matad	matadouro
matem	matemática
mater	material
matogros	mato-grossense
mato-gros	mato-grossense
máx	máximo
Mb	megabit
MB	megabyte
Mc	megaciclo
mcal	milicaloria
Mce	Mercê
mct	macuta
Md	megadina
Mdyn	megadina
mec	mecânica
mecân	mecânica
mecan	mecanografia
mecanogr	mecanografia
méd	médico
med	medieval
mediev	medieval
medv	medieval
mem	memorial
memor	memorandum
mens	mensal
mer	meridional
merc	mercúrio
mercad	mercadologia
merid	meridional
met	metátese
metáf	metáfora
metaf	metafórico
metafis	metafísica
metafór	metafórico
metal	metalurgia
metalog	metalografia
metalur	metalurgia
metát	metátese
meteor	meteorologia
meton	metonímia
metr	metrificação
metrif	metrificação
metrol	metrologia
mex	mexicano
mexic	mexicano
mg	miligrama
mgf	miligrama-força
mgr	milígrado
mH	milihenry
micol	micologia
microbiol	microbiologia
microfot	microfotografia
microg	micrografia
microl	micrologia
microm	micrometria
microsc	microscopia
microscóp	microscópico
mín	mínimo
min	minuto
miner	mineralogia
ming	minguante
minh	minhoto
minúsc	minúsculo
mist	misticismo
míst	místico
mit	mitologia
mitol	mitologia
mitôn	mitônimo
mk	marco
ml	mililitro
Ml	mirialitro
Mlle	senhorita
MM	Majestades
MM	meritíssimo
mm	milímetro
Mm	miriâmetro
Mme	madame
mme	madame
moag	moagem
mob	mobiliário
moçamb	moçambicanismo
mod	moderno
mod	moderno
monog	monografia
monogr	monografia
Mons	monsenhor
mons	monsenhor
mont	montaria
montanh	montanhismo
mor	moralismo
moralid	moralidade
morf	morfologia
morfol	morfologia
mov	movimento
Mr	senhor
Mrs	senhora
MS	manuscrito
ms	manuscrito
Ms	manuscrito
mss	manuscritos
mth	militermia
mult	multiplicativo
mun	municipal
mus	museologia
mús	música
mús	música
museol	museologia
mV	milivolt
n	neutro
N	norte
nac	educação	nacional
nac	nacional
nat	natural
natur	naturalismo
náu	náuatle
náua	náuatle
náut	náutico
nav	naval
naz	nazismo
NE	Nordeste
neerl	neerlandês
neg	negativo
neo-ár	neo-árico
neoguin	neoguinéu
neol	neologia
neolog	neologismo
neozel	neozelandês
nep	nepalês
neur	neurologia
neutr	neutralmente
nicar	nicaraguense
nicarag	nicaraguense
nig	nigeriano
niger	nigeriano
NNE	Nor-Nordeste
NNO	Nor-Noroeste
NNW	Nor-Noroeste
NO	Noroeste
nobil	nobiliarquia
nom	nome
nor	norueguês
nórd	nórdico
norm	normalização
normat	normativo
nort-am	norte-americano
norueg	norueguês
notic	noticiário
nov	novembro
nucl	nuclear
num	numeral
núm	número
numis	numismática
numism	numismática
nutr	nutrição
NW	Noroeste
NW	Noroeste
O	Oeste
ob	obra
obed	obediente
obj	objeto
obs	observação
obsol	obsoleto
obst	obstetrícia
obstet	obstetrícia
oc	ocidental
ocean	oceanografia
oceanogr	oceanografia
ocid	ocidental
ocul	oculista
ocult	ocultismo
odont	odontologia
odontol	odontologia
Of	oferecer
of	oficial
ofid	ofidismo
oft	oftalmologia
oftalm	oftalmologia
oftalmol	oftalmologia
olig	oligarquia
onç	onça
oneol	oneologia
ONO	Oés-Nordeste
ONO	Oés-Noroeste
onom	onomatopéia
onomást	onomástica
onomat	onomatopéia
onomatop	onomatopéico
op	obra
ópt	óptica
ópt	óptimo
optat	optativo
or	oriental
orat	oratória
ord	ordinal
org	organismo
organiz	organização
orig	originário
origin	originário
orign	originariamente
orn	ornitologia
ornit	ornitologia
ornitol	ornitologia
orog	orografia
orogr	orografia
orôn	orônimo
ort	ortografia
ortogr	ortografia
ortográf	ortográfico
ortop	ortopedia
ostr	ostreicultura
otorr	otorrinolaringologia
otorrin	otorrinolaringologia
our	ourivesaria
ouriv	ourivesaria
out	outubro
p	página
pag	paganismo
pág	página
págg	páginas
págs	páginas
pal	palavra
paleob	paleobotânica
paleog	paleografia
paleogr	paleografia
paleont	paleontologia
paleontol	paleontologia
paleoz	paleozoologia
pals	palavras
pan	panamenho
pan-amer	panamericanismo
panam	panamenho
paq	paquistanês
paraens	paraense
paraib	paraibano
paral	paralelo
paral	paralelo
paran	paranaense
paras	parasitologia
parassint	parassintético
parl	parlamentar
parn	parnasianismo
parnas	parnasianismo
parôn	parônimo
part	particípio
partic	particípio
partic	particularmente
pass	passado
passm	passamanaria
passr	passaricultura
passt	passatempos
past	pastelaria
pat	patologia
patol	patologia
pátr	pátrio
patr	patronímico
patrpatronímico
patron	patronímico
patrôn	patrônimo
paul	paulista
paulist	paulistano
pç	peça
pça	peça
pdl	poundal
Pe	Padre
pec	pecuária
ped	pediatria
ped	pedologia
pedag	pedagogia
pediat	pediatria
pedol	pedologia
pedr	pedreiras
pej	pejorativo
pen	penal
pen	penal
pent	penteado
peq	pequeno
per	persa
pér	pérsico
perf	perfeito
perfum	perfumaria
períf	perífrase
perífr	perífrase
pern	pernambucano
pernamb	pernambucano
pers	persa
pérs	pérsico
perspect	perspectiva
perspectiv	perspectivismo
peruv	peruviano
pesc	pescaria
pesq	pesquisa
pess	pessoal
pess	pessoal
pet	petrografia
petr	petrografia
petrog	petrografia
petrol	petrologia
petroq	petroquímica
pf	pfennig
pg	pago
píl	pílula
pint	pintura
pirot	pirotecnia
pirot	pirotécnica
pirotec	pirotecnia
pirotéc	pirotécnica
pisc	piscicultura
piscic	piscicultura
pizz	pizzicato
pk	peck
pl	plural
planej	planejamento
plást	plástico
plat	platino
pleb	Plebeísmo
plur	plural
PM	Polícia
pm	preamar
poes	poesia
poét	poética
pol	polegada
políc	polícia
polin	polinésio
polít	política
pop	população
popul	população
port	português
porto-riq	porto-riquenho
posit	positivismo
poss	possessivo
possess	possessivo
pot	potologia
potam	potamônimo
pov	povoado
pp	páginas
PP	Paternidades
pq	porque
pr	próprio
prác	prácrito
prát	prático
prec	precedente
preced	precedente
precis	precisamente
pred	predicativo
predic	predicativo
Pref	prefeito
pref	prefeito
pré-hist	pré-história
prep	preposição
prepos	prepositivo
pres	presente
presc	prescrição
presid	presidência
prest	prestidigitação
pret	pretérito
pret	pretérito
prev	previdência
prim	primitivo
princ	principal
princip	principado
priv	privativo
probl	problema
problem	problemático
proc	processo
Prof	professor
prof	professor
Profa	professora
profa	professora
Profas	professoras
profas	professoras
profis	profissão
profiss	profissão
profission	profissionalismo
Profs	professores
profs	professores
prom	promoção
pron	pronome
pronom	pronominal
pronún	pronúncia
prop	proporcional
propag	propaganda
propos	proposição
propr	propriamente
pros	prosódia
prosc	proscênio
prosôn	prosônimo
prost	prostético
prostét	prostético
prót	prótese
prot	protético
protest	protestante
protét	protético
protoc	protocolo
protoz	protozoário
prov	província
provav	provavelmente
provb	provérbio
provç	provençal
provc	província
proven	provençal
provenç	provençal
provinc	provincial
próx	próximo
PS	post-scriptum
pseud	pseudônimo
psic	psicologia
psican	psicanálise
psicofisl	psicofisiologia
psicogn	psicogonia
psicol	psicologia
psicopat	psicopatologia
psiq	psiquiatria
psiquiat	psiquiatria
pto	ponto
pts	pontos
pub	publicação
públ	público
public	publicação
pug	pugilismo
pz	piezo
q	que
Q-G	quartel-general
QG	quartel-general
ql	quilate
qto	quanto
qual	qualificativo
qualif	qualificativo
quant	quantidade
quantit	quantitativo
quart	quarteirão
quart	quartilho
quest	questionário
quí	quíchua
quích	quíchua
quím	química
quimb	quimbundo
quinz	quinzenal
quinzen	quinzenário
quir	quiromancia
quirom	quiromancia
r	reflexo
R	rua
radioat	radioatividade
radiod	radiodifusão
radiodif	radiodifusão
radiog	radiograma
radiogr	radiografia
radiol	radiologia
radiot	radiotécnica
radiot	radioterapia
radiotec	radiotecnia
radiotéc	radiotécnica
radiotécn	radiotécnica
radioter	radioterapia
rall	rallentando
rb	rublo
Rd	rádio
rdfot	radiofoto
rdlux	radiolux
real	realismo
realid	realidade
rec	receita
recip	reciprocidade
recíp	recíproco
recípr	recíproco
red	redução
ref	referência
refl	refletido
refl	reflexivo
reflex	reflexivo
reg	região
reg	regular
regim	regimento
region	regionalismo
regress	regressivo
rel	relativo
rel	religioso
relat	relatividade
relativ	relatividade
relig	religião
reloj	relojoaria
rep	república
repart	repartição
repert	repertório
report	reportagem
repúb	república
res	residência
rest	restrito
restr	restrição
restrit	restritivo
result	resultado
ret	retórica
retór	retórica
retrosp	retrospectivo
rev	reverendo
Rev	Reverendo
Revas	Reverências
Revdo	Reverendo
revers	reversível
Revmas	Suas	Reverendíssimas
Revmo	Reverendíssimo
rg	registro
rib	ribeira
rod	rodésio
rom	romano
rom	romano
rot	roteiro
RR	Reais
rs	réis
rub	rublo
rur	rural
rus	russo
russ	russo
rúst	rústico
S	Santo
s	segundo
sab	saboaria
sac	sacerdote
sagr	sagrado
sal	salina
sals	salsicharia
san	sanitário
sân	sânscrito
sâns	sânscrito
sânscr	sânscrito
sap	sapataria
sapat	sapataria
Sarg	Sargento
Sarg-Aj	Sargento-Ajudante
Sas	Senhorias
sát	sátira
Sb	stilb
sc	scilicet
sch	schilling
scr	sânscrito
SE	Sudeste
SE	Sudoeste
sec	secretaria
Sec	Secretaria
séc	século
sec	segundo
secr	secretaria
sécs	séculos
sect	sectarismo
seg	segundo
segg	seguintes
segs	seguintes
sel	seleção
sem	semana
semânt	semântica
semic	semicantão
semin	seminário
semiol	semiologia
semít	semítico
semit	semitismo
sen	seno
sent	sentença
sep	separado
septent	septentrional
seq	seguinte
seqq	seguintes
sér	sérvio
ser-cr	servo-croata
serg	sergipano
seric	sericicultura
serralh	serralharia
serv	serviço
sérv	sérvio
set	setembro
sg	singular
siam	siamês
sib	siberiano
sid	siderurgia
sider	siderotécnica
siderogr	siderografia
siderotéc	siderotécnica
sigil	sigilografia
sign	significação
síl	sílaba
silv	silvicultura
silvic	silvicultura
símb	símbolo
simb	simbologia
simból	simbólica
simbol	simbologia
simpl	simplesmente
sin	sinaleiro
sin	sinônimo
sinéd	sinédoque
sing	singular
sinon	sinonímia
sint	sintaxe
sínt	síntese
sir	siríaco
sír	sírio
sist	sistema
sit	situado
Snr	senhor
Snra	senhora
SO	Sudoeste
soc	social
sociol	sociologia
sól	sólido
son	sonoplastia
Sor	Sênior
sor	sorologia
Sór	sóror
sos	socorro
SOS	socorro
sost	sostenuto
sov	soviético
soviét	soviético
sp	espécie
spp	espécies
sq	quadrado
Sr	senhor
sr	senhor
Sra	senhora
sra	senhora
Sras	senhoras
sras	senhoras
Sres	senhores
sres	senhores
Srs	senhores
srs	senhores
Srta	senhorita
srta	senhorita
Srtas	senhoritas
srtas	senhoritas
SS	Santidades
ss	seguintes
SSE	Su-Sueste
SSO	Su-Sudoeste
SSW	Su-Sudoeste
st	estéreo
Sta	Santa
sta	santa
stac	staccato
Stas	Santas
stas	santas
St-Cu	estrato-cúmulo
sth	esteno
Sto	Santo
sto	santo
Stos	Santos
stos	santos
sub	subjuntivo
subafl	subafluente
subafls	subafluentes
Subdiác	subdiácono
subj	subjuntivo
subjunt	subjuntivo
subord	subordinativo
subst	substantivo
subvar	subvariante
Suc	sucessor
suc	sucursal
sue	sueco
suec	sueco
suf	sufixo
suj	sujeito
sup	superlativo
superf	superfície
superl	superlativo
supl	suplemento
suprf	superfície
suprs	superstição
surr	surrealismo
surreal	surrealismo
SV	sotavento
SW	Sudoeste
t	tonelada
tab	tabela
táb	táboa
tai	taino
taí	taíno
tail	tailandês
tam	tamul
tâm	tâmul
tan	tanoaria
tang	tangente
tanoar	tanoaria
taquigr	taquigrafia
tard	tardio
tát	tática
taur	tauromaquia
taurom	tauromaquia
taxid	taxidermia
tb	também
tc	teclar
teat	teatro
teatr	teatro
tec	tecelagem
téc	técnica
técn	técnica
tecn	tecnologia
tecnog	tecnografia
tecnogr	tecnografia
tecnol	tecnologia
tect	tectônico
tel	telefone
telec	telecomunicações
telecom	telecomunicações
telef	telefone
teleg	telégrafos
telegr	telegrafia
telégr	telégrafo
telem	telemetria
telev	televisão
temp	temperatura
temper	temperatura
Ten	Tenente
ten	tenente
Ten-Cel	tenente-coronel
ten-cel	tenente-coronel
teol	teologia
teôn	teônimo
teor	teorema
teos	teosofia
terap	terapêutica
terapêut	terapêutica
terat	teratologia
teratol	teratologia
térm	térmico
term	terminação
termin	terminologia
terminol	terminologia
termod	termodinâmica
termodinâm	termodinâmica
termom	termometria
terr	território
territ	território
tes	tesoureiro
test	testemunha
têxt	têxtil
tf	tonelada-força
th	termia
tib	tibetano
tibet	tibetano
tint	tintura
tipogr	tipografia
tipol	tipologia
tir	tiragem
tít	título
ton	tonel	ou	tonéis
tôn	tônico
tóp	tópico
top	topônimo
top	topônimo
topog	topografia
topogr	topografia
topol	topologia
topon	toponímia
topôn	topônimo
torp	torpedeiro
tosc	toscano
tox	toxicologia
toxiol	toxiologia
tr	transitivo
trab	trabalho
trabalh	trabalhismo
trad	tradução
tradic	tradicional
tráf	tráfego
trans	transitivo
transit	transitivo
transj	transjordano
transm	transmontano
transmont	transmontano
transobj	transobjetivo
transp	transportes
trat	tratado
trat	tratamento
Trav	travessa
trib	tribunal
trig	trigonometria
trigon	trigonometria
trim	trimestral
trimest	trimestral
trit	triticultura
triv	trivial
trop	tropical
TT	termos
Tte	tenente
Tte-Cel	tenente-coronel
tte-cel	tenente-coronel
tun	tunisino
tunis	tunisiano
tup	tupi
tupi-guar	tupi-guarani
tur	turismo
turc	turco
turism	turismo
tv	televisão
ucr	ucraíno
ucraín	ucraíno
ucran	ucraniano
ult	último
umb	umbanda
un	unidade
unif	uniforme
univ	universal
univers	universidade
urb	urbanismo
urban	urbanista
urol	urologia
urug	uruguaio
us	usado
usual	usualmente
utilid	utilidade
utilit	utilitarismo
utop	utopismo
v	vide
V	volt
V-Alm	vice-almirante
v-alm	vice-almirante
VA	Vossa	Alteza
vad	vademeco
vadm	vademeco
val	valão
var	variação
vasc	vasconço
vb	verbo
vc	você
Vde	visconde
Vdessa	viscondessa
veg	vegetal
vel	velocidade
veloc	velocipedia
ven	venatório
venat	venatório
venez	venezuelano
venezuel	venezuelano
verb	verbal
verbal	verbalismo
vern	vernáculo
vers	versificação
versif	versificação
vet	veterinário
veter	veterinária
vid	vide
Vig	Vigário
vig	vigário
vin	vinicultura
vinic	vinicultura
viol	violino
vit	viticultura
vitic	viticultura
vitr	vitral
viz	videlicet
vl	violino
vmce	vosmecê
vmces	vosmecês
vo	verso
voc	vocábulo
vog	vogal
vol	volume
volat	volataria
voll	volumes
vols	volumes
vs	versus
vulc	vulcânico
vulg	vulgar
VV	Vossas
W	Oeste
w	watt
WC	toalete
Wh	watt-hora
wh	watt-hora
WNW	Oés-Noroeste
WNW	Oés-Noroeste
Ws	watt-segundo
ws	watt-segundo
WSW	Oés-Sudoeste
xenof	xenofobia
xerog	xerografia
xerogr	xerografia
xilog	xilogravura
xin	xintoísta
yd	jarda
zend	zende
zo	zoologia
zool	zoologia
zoot	zootecnia
zootec	zootecnia
zootéc	zootécnica